111111111111111111111111111111111111111111111111111111111111164020000031111111111111111111111111111111111111111111111111111111111111111111111111
111111111111111111111111111111111111111111111111111111111111140020000031160020000031111111111111111111111111111111111111111111111111111111111111
111111111111111111111111111111111111111111111111160020000031100020000031140020000031111111111111111111111111111111111111111111111111111111111111
111111111111111111111111111111111111111111111111140020000031100020000031100026200031100000000031111111111111111111111111111111111111111111111111
111111111111161111111111101111111111101111111111100000000111100032300111100024200111100032300111100000000111111111111111111111111111111111111111
111111111111146000003111122300111111132000020111103000010111101111110111100000000111111111111111111111111111111111111111111111111111111111111111
111111111001104600000021122002000031100010110021100010110031100010110021100110110031100110100021100113120031100311100021131300000131111111111111
111111111111100400300001100000200221133000202331133006302331122220000001100000111101111111111101300111111001000111111201200000000001003111111111
111111111111160000111111111010111111110010100111110314102111110020100111110010110111112210100111110010102001113110100031113000000131111111111111
111111111111141111111131101111111131100200020031100100010031100002000031130200020331110222221111110000001111111111000031111111000031111111111111